#BEGIN THE LEVEL1#

#SET MAP SIZE IN PIXELS#

#ROWS = 2000#
#COLUMNS = 4000#

#PLAYERPOS = 1000, 100#